1 1 1 1 1 1 1 1 1 1
1 2 2 3 2 2 1 6 6 1
1 2 3 2 3 2 1 6 6 1
1 7 1 1 1 2 1 1 2 1
1 3 6 6 1 3 2 3 2 1
1 3 6 6 1 3 2 3 2 1
1 2 1 1 1 7 1 6 6 1
1 2 1 2 3 7 1 6 6 1
1 2 1 5 1 7 1 1 1 1
1 2 1 1 1 2 2 2 2 1
1 3 3 7 7 2 2 4 2 1
1 3 3 1 1 2 2 2 2 1
1 1 1 1 1 1 1 1 1 1
