1 1 1 1 1 1 1 1 1 1
1 2 2 2 1 2 1 2 3 1
1 4 2 1 1 2 8 2 5 1
1 2 2 6 2 2 1 2 3 1
1 1 6 1 8 1 1 1 1 1
1 2 2 1 2 2 1 3 3 1
1 2 3 1 2 2 8 7 3 1
1 1 2 1 2 2 1 3 3 1
1 7 2 1 3 2 1 1 1 1
1 2 1 1 2 2 1 2 2 1
1 3 6 6 2 2 8 7 3 1
1 2 1 1 1 7 1 2 2 1
1 1 1 1 1 1 1 1 1 1
