1 1 1 1 1 1 1 1 1 1
1 2 2 2 1 2 1 2 3 1
1 4 2 1 1 2 10 2 5 1
1 2 2 7 2 2 1 2 3 1
1 1 7 1 10 1 1 1 1 1
1 2 2 1 2 2 1 3 3 1
1 2 3 1 2 2 10 8 3 1
1 1 2 1 2 2 1 3 3 1
1 8 2 1 3 2 1 1 1 1
1 2 1 1 2 2 1 2 2 1
1 3 7 7 2 2 10 8 3 1
1 2 1 1 1 8 1 2 2 1
1 1 1 1 1 1 1 1 1 1
