1 1 1 1 1 1 1 1 1 1
1 2 2 2 1 2 1 2 3 1
1 12 2 1 1 2 7 2 4 1
1 2 2 5 2 2 1 2 3 1
1 1 5 1 7 1 1 1 1 1
1 2 2 1 2 2 1 3 3 1
1 2 3 1 2 2 7 6 3 1
1 1 2 1 2 2 1 3 3 1
1 6 2 1 3 2 1 1 1 1
1 2 1 1 2 2 1 2 2 1
1 3 5 5 2 2 7 6 3 1
1 2 1 1 1 6 1 2 2 1
1 1 1 1 1 1 1 1 1 1
