1 1 1 1 1 1 1 1 1 1
1 2 4 2 2 2 2 2 2 1
1 1 1 1 1 1 9 1 1 1
1 2 2 3 3 2 10 2 2 1
1 9 1 1 1 1 1 1 1 1
1 10 2 2 2 9 2 3 2 1
1 1 1 1 1 1 3 1 1 1
1 2 2 2 2 2 2 2 2 1
1 2 9 2 2 2 2 2 2 1
1 1 2 2 9 1 10 1 2 1
1 1 1 10 3 1 5 1 2 1
1 1 1 1 3 1 1 1 2 1
1 1 1 1 1 1 1 1 1 1
