1 1 1 1 1 1 1 1 1 1
1 2 4 2 2 2 2 2 2 1
1 1 1 1 1 1 11 1 1 1
1 2 2 3 3 2 12 2 2 1
1 11 1 1 1 1 1 1 1 1
1 12 2 2 2 11 2 3 2 1
1 1 1 1 1 1 3 1 1 1
1 2 2 2 2 2 2 2 2 1
1 2 11 2 2 2 2 2 2 1
1 1 2 2 11 1 12 1 2 1
1 1 1 12 3 1 5 1 2 1
1 1 1 1 3 1 1 1 2 1
1 1 1 1 1 1 1 1 1 1
