1 1 1 1 1 1 1 1 1 1
1 2 12 2 2 2 2 2 2 1
1 1 1 1 1 1 8 1 1 1
1 2 2 3 3 2 9 2 2 1
1 8 1 1 1 1 1 1 1 1
1 9 2 2 2 8 2 3 2 1
1 1 1 1 1 1 3 1 1 1
1 2 2 2 2 2 2 2 2 1
1 2 8 2 2 2 2 2 2 1
1 1 2 2 8 1 9 1 2 1
1 1 1 9 3 1 4 1 2 1
1 1 1 1 3 1 1 1 2 1
1 1 1 1 1 1 1 1 1 1
