1 1 1 1 1 1 1 1 1 1
1 5 1 1 1 1 1 3 3 1
1 4 6 2 2 7 1 3 3 1
1 6 1 1 9 1 1 1 8 1
1 3 1 2 2 2 1 1 10 1
1 3 1 2 2 2 2 2 2 1
1 10 1 2 2 2 2 2 2 1
1 2 1 2 2 2 1 2 2 1
1 2 2 2 2 1 1 1 2 1
1 1 1 1 2 1 1 1 9 1
1 1 1 1 2 6 6 2 2 1
1 1 1 1 1 3 3 1 1 1
1 1 1 1 1 1 1 1 1 1
