1 1 1 1 1 1 1 1 1 1
1 5 1 1 1 1 1 3 3 1
1 4 7 2 2 8 1 3 3 1
1 7 1 1 11 1 1 1 10 1
1 3 1 2 2 2 1 1 12 1
1 3 1 2 2 2 2 2 2 1
1 12 1 2 2 2 2 2 2 1
1 2 1 2 2 2 1 2 2 1
1 2 2 2 2 1 1 1 2 1
1 6 6 6 2 1 1 1 11 1
1 6 6 6 2 7 7 2 2 1
1 1 1 1 1 3 3 1 1 1
1 1 1 1 1 1 1 1 1 1
