1 1 1 1 1 1 1 1 1 1
1 2 2 2 2 12 2 2 2 1
1 2 8 2 3 3 2 8 6 1
1 9 1 2 1 1 2 1 9 1
1 2 2 2 2 2 2 2 2 1
1 2 2 2 2 2 2 2 2 1
1 2 2 1 1 7 1 2 2 1
1 2 3 1 4 3 1 2 3 1
1 1 7 1 1 1 1 5 1 1
1 9 2 3 3 3 2 2 2 1
1 2 1 1 1 1 1 1 5 1
1 5 2 3 6 3 2 2 2 1
1 1 1 1 1 1 1 1 1 1
