1 1 1 1 1 1 1 1 1 1
1 2 2 2 2 4 2 2 2 1
1 2 11 2 3 3 2 11 8 1
1 12 1 2 1 1 2 1 12 1
1 2 2 2 2 2 2 2 2 1
1 2 2 2 2 2 2 2 2 1
1 2 2 1 1 10 1 2 2 1
1 2 3 1 5 3 1 2 3 1
1 1 10 1 1 1 1 7 1 1
1 12 2 3 3 3 2 2 2 1
1 2 1 1 1 1 1 1 7 1
1 7 2 3 8 3 2 2 2 1
1 1 1 1 1 1 1 1 1 1
