1 1 1 1 1 1 1 1 1 1
1 2 2 2 2 4 2 2 2 1
1 2 9 2 3 3 2 9 7 1
1 10 1 2 1 1 2 1 10 1
1 2 2 2 2 2 2 2 2 1
1 2 2 2 2 2 2 2 2 1
1 2 2 1 1 8 1 2 2 1
1 2 3 1 5 3 1 2 3 1
1 1 8 1 1 1 1 6 1 1
1 10 2 3 3 3 2 2 2 1
1 2 1 1 1 1 1 1 6 1
1 6 2 3 7 3 2 2 2 1
1 1 1 1 1 1 1 1 1 1
