1 1 1 1 1 1 1 1 1 1
1 1 9 2 9 2 1 1 2 1
1 9 4 9 2 9 2 1 2 1
1 2 9 1 3 1 9 1 3 1
1 9 2 9 2 9 1 1 9 1
1 1 9 2 10 2 1 7 3 1
1 2 3 2 1 9 1 2 9 1
1 9 1 1 9 2 1 2 3 1
1 10 9 2 2 3 2 2 10 1
1 2 2 1 1 8 1 1 9 1
1 3 2 1 2 3 2 1 2 1
1 2 1 1 2 5 2 1 9 1
1 1 1 1 1 1 1 1 1 1
