1 1 1 1 1 1 1 1 1 1
1 1 8 2 8 2 1 1 2 1
1 8 12 8 2 8 2 1 2 1
1 2 8 1 3 1 8 1 3 1
1 8 2 8 2 8 1 1 8 1
1 1 8 2 9 2 1 6 3 1
1 2 3 2 1 8 1 2 8 1
1 8 1 1 8 2 1 2 3 1
1 9 8 2 2 3 2 2 9 1
1 2 2 1 1 7 1 1 8 1
1 3 2 1 2 3 2 1 2 1
1 2 1 1 2 4 2 1 8 1
1 1 1 1 1 1 1 1 1 1
