1 1 1 1 1 1 1 1 1 1
1 1 11 2 11 2 1 1 2 1
1 11 4 11 2 11 2 1 2 1
1 2 11 1 3 1 11 1 3 1
1 11 2 11 2 11 1 1 11 1
1 1 11 2 12 2 1 8 3 1
1 2 3 2 1 11 1 2 11 1
1 11 1 1 11 2 1 2 3 1
1 12 11 2 2 3 2 2 12 1
1 2 2 1 1 10 1 1 11 1
1 3 2 1 2 3 2 1 2 1
1 2 1 1 2 5 2 1 11 1
1 1 1 1 1 1 1 1 1 1
