1 1 3 2 3 2 3 2 1 1
1 1 2 1 1 1 1 3 1 1
1 1 3 1 2 4 1 2 1 1
1 1 2 3 2 3 1 2 1 1
1 1 1 1 1 1 1 7 1 1
1 1 10 2 8 12 2 3 1 1
1 1 1 1 1 1 1 11 1 1
1 1 9 8 3 5 11 2 1 1
1 1 6 1 5 5 1 2 1 1
1 1 8 1 5 5 1 5 1 1
1 1 9 8 2 3 10 3 1 1
1 1 1 1 1 1 1 1 1 1
1 1 1 1 1 1 1 1 1 1
