1 1 3 2 3 2 3 2 1 1
1 1 2 1 1 1 1 3 1 1
1 1 3 1 2 5 1 2 1 1
1 1 2 3 2 3 1 2 1 1
1 1 1 1 1 1 1 8 1 1
1 1 11 2 9 4 2 3 1 1
1 1 1 1 1 1 1 12 1 1
1 1 10 9 3 6 12 2 1 1
1 1 7 1 6 6 1 2 1 1
1 1 9 1 6 6 1 6 1 1
1 1 10 9 2 3 11 3 1 1
1 1 1 1 1 1 1 1 1 1
1 1 1 1 1 1 1 1 1 1
