1 1 3 2 3 2 3 2 1 1
1 1 2 1 1 1 1 3 1 1
1 1 3 1 2 5 1 2 1 1
1 1 2 3 2 3 1 2 1 1
1 1 1 1 1 1 1 10 1 1
1 1 13 2 11 4 2 3 1 1
1 1 1 1 1 1 1 14 1 1
1 1 12 11 3 7 14 2 1 1
1 1 8 1 7 7 1 2 1 1
1 1 11 1 7 7 1 7 1 1
1 1 12 11 2 3 13 3 1 1
1 1 1 1 1 1 1 1 1 1
1 1 1 1 1 1 1 1 1 1
